-----#-##----
-#---#----##-
-###-#-#-#-##
-----#-#-#---
#######---##-
-#------#--@-
-##########
-------##----