--##---##----
-#---#----##-
-###-#-#-#-##
-------#-#---
-######---##-
-#------##-@-
-############
-------##----