--##---##----
-#---#----##-
-###-#-#-#-##
-------#-#---
-######---##-
-#------#--@-
-############
-------##----